30 10
##############################
S.......#....#..#.......##.###
###.#######.#####.##.###...###
#...####..........##.....#...#
#.###.##.########.########.#.#
#.###....##.......#.##.....###
#....###.##.#######.##.####..G
####.###.##..#...##.##.###..##
#..........#...#....##.......#
##############################