10 9
S#########
.....#..##
####.#.###
#....#.#.#
###.##.#.#
#....#...#
#######.##
###.....##
######G###